Jacanidae = Microparra,Actophilornis,Irediparra,Hydrophasianus,Metopidius,Jacana
Lari=Charadrii = Alle,Alca,Pinguinus,Cepphus,Brachyramphus,Synthliboramphus,Ptychoramphus,Aethia,Cerorhinca,Fratercula,Stercorarius,Pluvianus,Cursorius,Rhinoptilus,Stiltia,Glareola,Dromas,Larus,Pagophila,Rhodostethia,Xema,Creagrus,Rissa,Sterna,Chlidonias,Phaetusa,Anous,Procelsterna,Gygis,Larosterna,Rynchops,Alle,Alca,Pinguinus,Cepphus,Brachyramphus,Synthliboramphus,Ptychoramphus,Aethia,Cerorhinca,Fratercula,Stercorarius,Pluvianus,Cursorius,Rhinoptilus,Stiltia,Glareola,Dromas
Leptosomidae = Leptosomus
Megapodiidae = Alectura,Aepypodius,Talegalla,Leipoa,Macrocephalon,Eulipoa,Megapodius
Mergini = Polystictus,Somateria,Histrionicus,Camptorhynchus,Melanitta,Clangula,Mergellus,Bucephala,Lophodytes,Mergus
Meropidae = Nyctyornis,Merops
Mesitornithidae = Mesitornis,Monias
Momotidae = Hylomanes,Momotus,Baryphthengus,Electron
MusophagidaeHughes2000 = Crinifer,Corythaixoides,Musophaga,Tauraco
Musophagidae = Corythaeola,Tauraco,Ruwenzorornis,Musophaga,Corythaixoides
Nettapodeae = Chenonetta,Nettapus
Newworldquail = Oreortyx,Callipepla,Philortyx,Colinus,Odontophorus,Cyrtonyx
Nyctibiidae = Nyctibius
Opisthocomidae = Opisthocomus
Other ramphastids = Pteroglossus,Baillonius,Selenidera,Andigena,Ramphastos
Otididae = Otis,Ardeotis,Chlamydotis,Neotis,Eupodotis,Lophotis,Afrotis,Lissotis,Houbaropsis,Sypheotides,Tetrax
Oxyurini = Heteronetta,Nomonyx,Biziura,Oxyura
Passeriformes = Acanthisitta,Xenicus,Smithornis,Calyptomena,Cymbirhynchus,Psarisomus,Serilophus,Eurylaimus,Pseudocalyptomena,Philepitta,Neodrepanis,Sapayoa,Pitta,Neopelma,Tyranneutes,Ilicura,Masius,Corapipo,Machaeropterus,Manacus,Antilophia,Chiroxiphia,Xenopipo,Heterocercus,Pipra,Tityra,Schiffornis,Laniocera,Iodopleura,Laniisoma,Xenopsaris,Pachyramphus,Ampelion,Zaratornis,Doliornis,Phytotoma,Carpornis,Pipreola,Oxyruncus,Ampelioides,Rupicola,Phoenicircus,Cotinga,Procnias,Lipaugus,Conioptilon,Porphyrolaema,Xipholena,Carpodectes,Gymnoderus,Querula,Haematoderus,Pyroderus,Perissocephalus,Cephalopterus,Piprites,Phyllomyias,Tyrannulus,Myiopagis,Elaenia,Ornithion,Camptostoma,Suiriri,Mecocerculus,Anairetes,Serpophaga,Phaeomyias,Capsiempis,Polystictus,Nesotriccus,Pseudocolopteryx,Pseudotriccus,Corythopis,Euscarthmus,Pseudelaenia,Stigmatura,Zimmerius,Phylloscartes,Mionectes,Leptopogon,Sublegatus,Inezia,Myiophobus,Myiotriccus,Tachuris,Hemitriccus,Oncostoma,Lophotriccus,Poecilotriccus,Todirostrum,Cnipodectes,Rhynchocyclus,Tolmomyias,Platyrinchus,Onychorhynchus,Myiobius,Terenotriccus,Neopipo,Pyrrhomyias,Hirundinea,Aphanotriccus,Cnemotriccus,Xenotriccus,Sayornis,Mitrephanes,Contopus,Empidonax,Pyrocephalus,Lessonia,Knipolegus,Hymenops,Ochthornis,Satrapa,Muscisaxicola,Agriornis,Xolmis,Heteroxolmis,Myiotheretes,Cnemarchus,Polioxolmis,Neoxolmis,Gubernetes,Muscipipra,Fluvicola,Arundinicola,Alectrurus,Ochthoeca,Colorhamphus,Colonia,Muscigralla,Machetornis,Legatus,Phelpsia,Myiozetetes,Pitangus,Conopias,Myiodynastes,Megarynchus,Tyrannopsis,Empidonomus,Tyrannus,Rhytipterna,Sirystes,Casiornis,Myiarchus,Deltarhynchus,Ramphotrigon,Attila,Batara,Mackenziaena,Frederickena,Taraba,Sakesphorus,Thamnophilus,Megastictus,Neoctantes,Thamnistes,Dysithamnus,Thamnomanes,Pygiptila,Myrmotherula,Dichrozona,Myrmorchilus,Herpsilochmus,Microrhopias,Formicivora,Drymophila,Terenura,Cercomacra,Pyriglena,Myrmoborus,Hypocnemis,Hypocnemoides,Myrmochanes,Gymnocichla,Sclateria,Percnostola,Myrmeciza,Myrmornis,Pithys,Gymnopithys,Rhegmatorhina,Hylophylax,Phlegopsis,Phaenostictus,Conopophaga,Pteroptochos,Scelorchilus,Rhinocrypta,Liosceles,Myornis,Scytalopus,Formicarius,Chamaeza,Pittasoma,Grallaria,Hylopezus,Myrmothera,Grallaricula,Geositta,Upucerthia,Chilia,Cinclodes,Furnarius,Sylviorthorhynchus,Aphrastura,Leptasthenura,Schizoeaca,Asthenes,Schoeniophylax,Synallaxis,Cranioleuca,Hellmayrea,Certhiaxis,Thripophaga,Spartonoica,Phleocryptes,Limnornis,Anumbius,Coryphistera,Eremobius,Siptornis,Premnornis,Premnoplex,Roraimia,Acrobatornis,Margarornis,Pseudoseisura,Pseudocolaptes,Berlepschia,Hyloctistes,Philydor,Anabazenops,Thripadectes,Automolus,Hylocryptus,Sclerurus,Lochmias,Xenops,Pygarrhichas,Dendrocincla,Deconychura,Sittasomus,Glyphorynchus,Drymornis,Nasica,Dendrexetastes,Hylexetastes,Xiphocolaptes,Dendrocolaptes,Xiphorhynchus,Lepidocolaptes,Campylorhamphus,Menura,Atrichornis,Ailuroedus,Archboldia,Amblyornis,Prionodura,Sericulus,Ptilonorhynchus,Chlamydera,Cormobates,Climacteris,Malurus,Clytomyias,Stipiturus,Amytornis,Lichenostomus,Meliphaga,Foulehaio,Manorina,Entomyzon,Melithreptus,Anthornis,Prosthemadera,Pycnopygius,Philemon,Acanthogenys,Anthochaera,Xanthomyza,Melipotes,Macgregoria,Melidectes,Ptiloprora,Melilestes,Lichmera,Trichodere,Grantiella,Phylidonyris,Ramsayornis,Conopophila,Acanthorhynchus,Certhionyx,Myzomela,Timeliopsis,Epthianura,Ashbyia,Dasyornis,Pardalotus,Pyrrholaemus,Oreoscopus,Crateroscelis,Sericornis,Smicrornis,Gerygone,Acanthiza,Aphelocephala,Mohoua,Pomatostomus,Orthonyx,Cnemophilus,Loboparadisea,Melanocharis,Oedistoma,Toxorhamphus,Oreocharis,Paramythia,Philesturnus,Psophodes,Ptilorrhoa,Cinclosoma,Bias,Batis,Lanioturdus,Platysteira,Tephrodornis,Philentoma,Prionops,Malaconotus,Chlorophanes,Telophorus,Rhodophoneus,Tchagra,Dryoscopus,Laniarius,Nilaus,Calicalicus,Vanga,Oriolia,Xenopirostris,Falculea,Artamella,Leptopterus,Cyanolanius,Schetba,Euryceros,Tylas,Hypositta,Newtonia,Pseudobias,Mystacornis,Cracticus,Gymnorhina,Strepera,Peltops,Artamus,Aegithina,Pityriasis,Coracina,Lalage,Campephaga,Pericrocotus,Daphoenositta,Falcunculus,Turnagra,Rhagologus,Pachycephala,Corvinella,Eurocephalus,Lanius,Cyclarhis,Vireolanius,Vireo,Hylophilus,Sphecotheres,Oriolus,Colluricincla,Pitohui,Oreoica,Chaetorhynchus,Dicrurus,Rhipidura,Hypothymis,Trochocercus,Terpsiphone,Chasiempis,Pomarea,Clytorhynchus,Metabolus,Monarcha,Grallina,Myiagra,Lamprolia,Platylophus,Platysmurus,Perisoreus,Cyanolyca,Cyanocorax,Calocitta,Cyanocitta,Aphelocoma,Gymnorhinus,Garrulus,Cyanopica,Urocissa,Cissa,Dendrocitta,Crypsirina,Temnurus,Pica,Zavattariornis,Podoces,Pseudopodoces,Nucifraga,Pyrrhocorax,Ptilostomus,Corvus,Corcorax,Struthidea,Melampitta,Manucodia,Phonygammus,Astrapia,Parotia,Pteridophora,Lophorina,Epimachus,Ptiloris,Diphyllodes,Cicinnurus,Seleucidis,Paradisaea,Peneothello,Tregellasia,Eopsaltria,Melanodryas,Pachycephalopsis,Monachella,Microeca,Eugerygone,Petroica,Drymodes,Picathartes,Bombycilla,Phainoptila,Phainopepla,Dulus,Parus,Melanochlora,Sylviparus,Remiz,Anthoscopus,Auriparus,Pholidornis,Psalidoprocne,Cheramoeca,Riparia,Tachycineta,Progne,Pygochelidon,Notiochelidon,Atticora,Neochelidon,Stelgidopteryx,Hirundo,Delichon,Cecropis,Petrochelidon,Aegithalos,Leptopoecile,Psaltriparus,Mirafra,Certhilauda,Ammomanes,Galerida,Alauda,Eremopterix,Eremophila,Cisticola,Scotocerca,Prinia,Schistolais,Apalis,Hypergerus,Eminia,Camaroptera,Neomixis,Orthotomus,Pycnonotus,Andropadus,Ixonotus,Chlorocichla,Phyllastrephus,Bleda,Criniger,Tricholestes,Hypsipetes,Elminia,Erythrocercus,Megalurus,Cincloramphus,Eremiornis,Schoenicola,Cettia,Bradypterus,Melocichla,Sphenoeacus,Locustella,Acrocephalus,Hippolais,Chloropeta,Macrosphenus,Hylia,Oxylabes,Cryptosylvicola,Thamnornis,Crossleyia,Phylloscopus,Seicercus,Abroscopus,Sylvietta,Sylvia,Parisoma,Pellorneum,Trichastoma,Malacocincla,Malacopteron,Illadopsis,Kakamega,Pomatorhinus,Xiphirhynchus,Jabouilleia,Kenopia,Napothera,Spelaeornis,Stachyris,Macronous,Timalia,Chrysomma,Chamaea,Turdoides,Babax,Garrulax,Liocichla,Leiothrix,Cutia,Pteruthius,Gampsorhynchus,Actinodura,Minla,Alcippe,Heterophasia,Yuhina,Panurus,Paradoxornis,Chaetops,Modulatrix,Zosterops,Rukia,Cleptornis,Irena,Regulus,Campylorhynchus,Odontorchilus,Salpinctes,Catherpes,Hylorchilus,Cinnycerthia,Cistothorus,Thryomanes,Thryothorus,Troglodytes,Thryorchilus,Henicorhina,Microcerculus,Cyphorhinus,Donacobius,Microbates,Ramphocaenus,Polioptila,Sitta,Tichodroma,Certhia,Salpornis,Dumetella,Melanoptila,Mimus,Oreoscoptes,Mimodes,Toxostoma,Ramphocinclus,Melanotis,Margarops,Cinclocerthia,Rhabdornis,Aplonis,Mino,Sarcops,Ampeliceps,Gracula,Acridotheres,Leucopsar,Sturnus,Creatophora,Lamprotornis,Cinnyricinclus,Onychognathus,Poeoptera,Grafisia,Speculipastor,Neocichla,Buphagus,Neocossyphus,Stizorhina,Zoothera,Ixoreus,Ridgwayia,Sialia,Myadestes,Cichlopsis,Catharus,Hylocichla,Entomodestes,Platycichla,Psophocichla,Turdus,Nesocichla,Cichlherminia,Cochoa,Chlamydochaera,Brachypteryx,Alethe,Pogonocichla,Swynnertonia,Stiphrornis,Sheppardia,Erithacus,Luscinia,Cossypha,Cercotrichas,Namibornis,Copsychus,Phoenicurus,Rhyacornis,Chaimarrornis,Enicurus,Saxicola,Oenanthe,Cercomela,Myrmecocichla,Thamnolaea,Monticola,Pseudocossyphus,Melaenornis,Rhinomyias,Muscicapa,Myioparus,Stenostira,Ficedula,Cyanoptila,Cyornis,Niltava,Culicicapa,Cinclus,Chloropsis,Prionochilus,Dicaeum,Anthreptes,Hypogramma,Nectarinia,Aethopyga,Arachnothera,Promerops,Plocepasser,Philetairus,Passer,Petronia,Montifringilla,Bubalornis,Dinemellia,Sporopipes,Amblyospiza,Ploceus,Malimbus,Quelea,Foudia,Euplectes,Parmoptila,Nigrita,Pytilia,Amadina,Mandingoa,Cryptospiza,Pyrenestes,Spermophaga,Hypargos,Lagonosticta,Uraeginthus,Estrilda,Amandava,Ortygospiza,Emblema,Neochmia,Poephila,Taeniopygia,Erythrura,Lonchura,Heteromunia,Vidua,Anomalospiza,Prunella,Peucedramus,Dendronanthus,Motacilla,Tmetothylacus,Macronyx,Anthus,Fringilla,Serinus,Linurgus,Rhynchostruthus,Carduelis,Leucosticte,Callacanthis,Rhodopechys,Uragus,Urocynchramus,Carpodacus,Pinicola,Haematospiza,Loxia,Pyrrhula,Coccothraustes,Eophona,Mycerobas,Pyrrhoplectes,Telespiza,Psittirostra,Dysmorodrepanis,Loxioides,Rhodacanthis,Chloridops,Pseudonestor,Hemignathus,Oreomystis,Paroreomyza,Loxops,Ciridops,Vestiaria,Drepanis,Palmeria,Himatione,Melamprosops,Vermivora,Parula,Dendroica,Catharopeza,Mniotilta,Setophaga,Protonotaria,Helmitheros,Limnothlypis,Seiurus,Oporornis,Geothlypis,Microligea,Teretistris,Wilsonia,Cardellina,Ergaticus,Myioborus,Euthlypis,Basileuterus,Phaeothlypis,Zeledonia,Granatellus,Xenoligea,Psarocolius,Ocyalus,Cacicus,Amblycercus,Icterus,Nesopsar,Gymnomystax,Macroagelaius,Hypopyrrhus,Lampropsar,Gnorimopsar,Curaeus,Amblyramphus,Xanthopsar,Pseudoleistes,Oreopsar,Molothrus,Dives,Agelaius,Euphagus,Quiscalus,Sturnella,Xanthocephalus,Dolichonyx,Coereba,Melophus,Emberiza,Calcarius,Plectrophenax,Calamospiza,Passerella,Melospiza,Zonotrichia,Junco,Passerculus,Ammodramus,Xenospiza,Spizella,Pooecetes,Chondestes,Amphispiza,Aimophila,Torreornis,Oriturus,Phrygilus,Haplospiza,Acanthidops,Lophospingus,Diuca,Poospiza,Sicalis,Emberizoides,Embernagra,Volatinia,Sporophila,Oryzoborus,Melopyrrha,Catamenia,Tiaris,Loxipasser,Loxigilla,Euneornis,Melanospiza,Geospiza,Camarhynchus,Certhidea,Pinaroloxias,Pipilo,Melozone,Arremonops,Buarremon,Atlapetes,Urothraupis,Saltatricula,Coryphospingus,Rhodospingus,Paroaria,Schistochlamys,Cissopis,Conothraupis,Lamprospiza,Sericossypha,Nemosia,Creurgops,Mitrospingus,Hemispingus,Cnemoscopus,Thlypopsis,Pyrrhocoma,Cypsnagra,Nephelornis,Eucometis,Tachyphonus,Lanio,Ramphocelus,Thraupis,Calochaetes,Buthraupis,Anisognathus,Chlorornis,Dubusia,Delothraupis,Iridosornis,Pipraeidea,Neothraupis,Chlorochrysa,Tangara,Tersina,Dacnis,Cyanerpes,Chlorophanes,Iridophanes,Heterospingus,Hemithraupis,Xenodacnis,Conirostrum,Oreomanes,Diglossa,Chlorospingus,Piranga,Habia,Chlorothraupis,Nesospingus,Phaenicophilus,Spindalis,Rhodinocichla,Euphonia,Catamblyrhynchus,Chlorophonia,Spiza,Pheucticus,Cardinalis,Caryothraustes,Parkerthraustes,Rhodothraupis,Saltator,Cyanoloxia,Cyanocompsa,Passerina
Pedionomidae = Pedionomus
Pelecanidae = Pelecanus
Pelecanoididae=Procellariidae = Pelecanoides
Phaethontidae = Phaethon
Phalacrocoracidae = Phalacrocorax
Phalacrocoracinae = Phalacrocorax
Phasianidae = Meleagris,Bonasa,Falcipennis,Canachites,Tetrao,Centrocercus,Dendragapus,Tympanuchus,Lagopus,Lerwa,Tetraogallus,Alectoris,Ammoperdix,Ptilopachus,Francolinus,Perdix,Rhizothera,Margaroperdix,Coturnix,Perdicula,Arborophila,Caloperdix,Haematortyx,Rollulus,Bambusicola,Galloperdix,Ithaginis,Tragopan,Pucrasia,Lophophorus,Gallus,Lophura,Crossoptilon,Catreus,Syrmaticus,Phasianus,Chrysolophus,Polyplectron,Rheinardia,Argusianus,Pavo,Afropavo
Phoenicopteridae = Phoenicopterus
Phoeniculidae = Phoeniculus,Rhinopomastus
Pici = Aulacorhynchus,Pteroglossus,Baillonius,Selenidera,Andigena,Ramphastos,Capito,Eubucco,Semnornis,Psilopogon,Megalaima,Gymnobucco,Stactolaema,Pogoniulus,Buccanodon,Tricholaema,Lybius,Trachyphonus,Jynx,Picumnus,Sasia,Melanerpes,Sphyrapicus,Campethera,Geocolaptes,Dendropicos,Dendrocopos,Picoides,Veniliornis,Piculus,Colaptes,Celeus,Dryocopus,Campephilus,Picus,Chrysocolaptes,Sapheopipo,Blythipicus,Meiglyptes,Mulleripicus,Indicator
Picidae = Jynx,Picumnus,Sasia,Melanerpes,Sphyrapicus,Campethera,Geocolaptes,Dendropicos,Dendrocopos,Picoides,Veniliornis,Piculus,Colaptes,Celeus,Dryocopus,Campephilus,Picus,Chrysocolaptes,Sapheopipo,Blythipicus,Meiglyptes,Mulleripicus
Piciformes = Galbalcyrhynchus,Brachygalba,Galbula,Jacamerops,Notharchus,Bucco,Nystalus,Malacoptila,Micromonacha,Nonnula,Hapaloptila,Monasa,Chelidoptera,Jynx,Picumnus,Sasia,Melanerpes,Sphyrapicus,Campethera,Geocolaptes,Dendropicos,Dendrocopos,Picoides,Veniliornis,Piculus,Colaptes,Celeus,Dryocopus,Campephilus,Picus,Chrysocolaptes,Sapheopipo,Blythipicus,Meiglyptes,Mulleripicus,Indicator,Aulacorhynchus,Pteroglossus,Baillonius,Selenidera,Andigena,Ramphastos,Capito,Eubucco,Semnornis,Psilopogon,Megalaima,Gymnobucco,Stactolaema,Pogoniulus,Buccanodon,Tricholaema,Lybius,Trachyphonus
Picoidea = Jynx,Picumnus,Sasia,Melanerpes,Sphyrapicus,Campethera,Geocolaptes,Dendropicos,Dendrocopos,Picoides,Veniliornis,Piculus,Colaptes,Celeus,Dryocopus,Campephilus,Picus,Chrysocolaptes,Sapheopipo,Blythipicus,Meiglyptes,Mulleripicus,Indicator
Pipridae = Neopelma,Tyranneutes,Ilicura,Masius,Corapipo,Machaeropterus,Manacus,Antilophia,Chiroxiphia,Xenopipo,Heterocercus,Pipra
Podargidae = Podargus,Batrachostomus
Podargidae+Batachostomidae = Podargus,Batrachostomus
Podicipedidae = Tachybaptus,Podilymbus,Podiceps,Aechmophorus
Procellariidae = Lugensa,Macronectes,Fulmarus,Thalassoica,Daption,Pagodroma,Halobaena,Pachyptila,Pterodroma,Pseudobulweria,Procellaria,Calonectris,Puffinus,Bulweria
Psittacidae = Nestor,Strigops,Psittrichas,Loriculus,Micropsitta,Probosciger,Calyptorhynchus,Callocephalon,Eolophus,Cacatua,Nymphicus,Eos,Trichoglossus,Psitteuteles,Lorius,Glossopsitta,Charmosyna,Oreopsittacus,Neopsittacus,Cyanoramphus,Purpureicephalus,Barnardius,Platycercus,Northiella,Psephotus,Neophema,Lathamus,Melopsittacus,Pezoporus,Psittacella,Geoffroyus,Eclectus,Alisterus,Polytelis,Psittacula,Agapornis,Coracopsis,Psittacus,Poicephalus,Anodorhynchus,Cyanopsitta,Ara,Aratinga,Nandayus,Pyrrhura,Myiopsitta,Brotogeris,Pionopsitta,Hapalopsittaca,Graydidascalus,Pionus,Amazona,Deroptyus,Triclaria,Cyclopsitta
Psittaciformes = Nestor,Strigops,Psittrichas,Loriculus,Micropsitta,Probosciger,Calyptorhynchus,Callocephalon,Eolophus,Cacatua,Nymphicus,Eos,Trichoglossus,Psitteuteles,Lorius,Glossopsitta,Charmosyna,Oreopsittacus,Neopsittacus,Cyanoramphus,Purpureicephalus,Barnardius,Platycercus,Northiella,Psephotus,Neophema,Lathamus,Melopsittacus,Pezoporus,Psittacella,Geoffroyus,Eclectus,Alisterus,Polytelis,Psittacula,Agapornis,Coracopsis,Psittacus,Poicephalus,Anodorhynchus,Cyanopsitta,Ara,Aratinga,Nandayus,Pyrrhura,Myiopsitta,Brotogeris,Pionopsitta,Hapalopsittaca,Graydidascalus,Pionus,Amazona,Deroptyus,Triclaria,Cyclopsitta
Psophiidae = Psophia
Pteroclidae = Syrrhaptes,Pterocles
